1111111111111
10C10000000C1
1CCC011111001
1PE0000000001
1111111111111