1111111111111
1XX1X000000C1
1X00011111001
1P0011E000001
1111111111111