1111111111111111111111111111111111
1C100001000XX000010000100001000XX1
1000010111111001010000111011000011
1011110100001C01010000001110001001
1000010100001100011101100010011001
1011110001000000010001000011110001
1010000101111111110001001000100011
1011100100000000010001011000101001
1010000111111111011011010011101001
1010100000000001001010010010001111
10111111000100X100101011E010000001
100000011111010100001CC11111110101
1000100100010101011111111000000001
11111001100101011100000000X1001001
1P00000000XXC1000001100010X1001001
1111111111111111111111111111111111