1111111111111111111111
1C000000000100C0X00001
1000000000000000000001
1101110000111100C00001
1E0000000011110000X001
111111110X011100P00001
1C0XX00000000100000X01
100X00000000010X000001
1101110000111100000001
10000000000C00000C0001
1111111111111111111111