1111111111111111111111111111111111
1E0000000000000C00000CX00000000001
101001010010000X101XX1000000010101
10100100101010100010010000000101X1
1P0000000C00C0000000000000000000C1
1111111111111111111111111111111111