1111111111111
10C10000000C1
1CCC011111X01
1PE000000XX01
1111111111111